150s 1d
WWWWWWWWWWWWWW
WGGGGGG.GGDGBW
WGBRBGGGGGG.GW
WGGGGGGGGGG.GW
WBGBBGGGGGGGGW
WGG.BGGGGGGGGW
WGGGGGG.GGGGEW
WWWWWWWWWWWWWW
