150s 3d
WWWWWWWWWWWWWW
WGGGGDG.GGDGDW
WGBRBGGGGGG.GW
WGBGGGGGGDGGGW
W.GGWWWWWWWWWW
WGGGGGG.BGGGGW
WD.B.GGGGGGEGW
WWWWWWWWWWWWWW
