150s 5d
WWWWWWWWWWWWWW
WDGGGDG.GGBGDW
WGBRBGGGGGB.GW
WWWWWWWWWWDGGW
WDGGGGBBDGG..W
WGGBGBG.BGGGGW
WD.B.GGGGGGEGW
WWWWWWWWWWWWWW
