142s 2d
WWWWWWWWWWWWWW
WGGGGGDG.GGGGW
WGBRGGGGGBGGDW
WGG.GBGGGGGGDW
WGGGG.DGBGBGGW
W.BBBGGBGDGGGW
WGGGGGBGG.GEGW
WWWWWWWWWWWWWW
